11111111111
100001E1001
1C00P111001
10000100001
1000000C001
10000000001
10010000001
1000001C001
10000000001
1000000C001
11111111101
100C000C001
10001000001
11111111111