11111111111
1000CP0E111
11111111111