
11111111111
1000CPE0001
11111111111