1111111111111111111111111111111111111111111
1PCC0000E1
1111111111111111111111111111111111111111111