11111111111111111111111111111111111111111111111111111111111
1ECCCCCCCCCCCCCCCCCCCCCCCCCCCCCCCCCCCCCCCCCCCCCCCP111111111
11111111111111111111111111111111111111111111111111111111111