1111111111111111
10000000000E0111
1001111111111001
1000C00000000001
1000111111111001
10000000000PP001
1000C0000000C001
1000111111111001
1000000000000001
1000C00000000001
1000111111111001
1111111111111111
