111111111111111111111111111111111111111111111111111111
1PCCCCCCCCCCCCCCCCCCCCCCCCCCCE111111111111111111111111
111111111111111111111111111111111111111111111111111111