1111111111111111
1E00000000000001
1001111111111001
1000C00000000001
1000111111111001
100000000000P001
1000C0000000C001
1000111111111001
1000000000000001
1000C00000000001
1000111111111001
1111111111111111