111111111111111111111111111111111111111111111111111111111111
1E0CC0000000000000000000P11111111111111111111111111111111111
111111111111111111111111111111111111111111111111111111111111